1111111111111
1C010010000C1
1000000000001
1000000000001
1000C11111001
1P1111E000001
1111111111111