1111111111111
1C010000000C1
1000001000001
1000001000001
1000C11111001
1P1111E000001
1111111111111