1111111111111
1C010100000C1
1000010000001
1000010000001
1000C11111001
1P1111E000001
1111111111111